WWWWWWWWWWWWWWWWW
WBOOOOOOWOOOOOOBW
WOWWOWWOWOWWOWWOW
WOOOOOOOOOOOOOOOW
WOWWOWWWWWWWOWWOW
WOWWOOOOWOOOOWWOW
WOWWWWWOWOWWWWWOW
WOOOOOOOOOOOOOOOW
WOWWWOWSSSWOWWWOW 
WOOOOOWSSSWOOOOOW
WWOWWOWWWWWOWWOWW
WOOWOOOOOOOOOWOOW
WOWWOWWWOWWWOWWOW
WBOOOOOOOOOOOOOBW
WWWWWWWWWWWWWWWWW